########################
#..........D...........#
#..####......####......#
#..#..#......#..#..H...#
#..#..D......D..#......#
#..####..L...####......#
#......................#
#......######..........#
#......#....#..........#
#..H...#....D..........#
#......######..........#
#......................#
########################
